000000000000000000000000000000
000011111111111111111111111100
000011111111111111111111111100
000000001122222222222211000000
000000001122222222222211000000
000000111122333333332211110000
000000111122333333332211110000
000011111122334444332211111100
001111111122334554332211111111
001111111122334554332211111111
000011111122334444332211111100
000000111122333333332211110000
000000111122333333332211110000
000000001122222222222211000000
000000001122222222222211000000
000011111111111111111111111111
000011111111111111111111111111
000000000000000000000000000000
